http://alamannien.com/resources/Runen.jpg

Dal 27-11-2017 interogazione

Runa -> -s Geheimnis -> segreto
Magichen zeichen -> segni magici
Politeischen religion -> religione poiteista
non avevano papiri, scrivevano su waffen (armi) o holz (legno)
questi segreti -> eckig -> spigolisi -> nicht rund -> non rotondi
einritzen -> eingravieren -> incidere
non erano circolari perché il materiale non lo permetteva,
questi segreti li troviamo in diversi luoghi
l'alfaboeto dei segreti è "Futhark" ed è composto da 16 a 24 Runen
Furhark deriva dalle prime 6 rune
bestehen -> essere composto

fihu -> -s Vieh -> bestiame

PEK^U è in indoeuropeo (6000 a.C.) -> ricostruito
Nel latino diventa pecus -> pecoris 
Pecunia -> soldi
Pecore (in italiano ha uno slittamento semantico

1° Lautverschidung -> prima rotazione consonantica (IE -> Germanisch)
p -> f
T -> bp
j -> h
k^w -> h^w

2* Lautverschidung -> seconda rotazione consonantica (Germanisch -> Althochdeutsch)
p -> pf/f
t -> ts

Stabrein -> allitterazione
Zwech -> obiettivo
dienten -> servire
erfoschen -> supplicare

ENG | DEU
ship -> Schiff
ten -> Zehn
two -> Zwei
dwarf -> Zwerch
pepper -> Pfeffer
token -> Zeichen
apple -> Apfel
heart -> Herz

al nord non hanno fatto il secondo Lautverschidung

Lehnwort -> prestito linguistico

tzt -> africata, 2 suoni insieme (anche la g morbida)

Roma politeista, anche i germanici
Zeus -> prende la pronuncia "Zois" -> Il greco cambia di pronuncia, il latino no.

I GIORNI -> ogni giorno ad una divinità
lunae-dies | Monday | Montag
martis-dies | Tuesday | Dienstag -> legge marziale -> guerra
merucirii-dies | Wednesday | Mittwoch
iovis-dies | Thursday | Donnerstag
veneris dies | Friday | Freitag
